¨€¨€¨€¨€¨€¨€¨€¨€¨€¨€¨€¨€¨€¨€¨€¨€¨€¨€¨€¨€¨€¨€¨€¨€¨€¨€¨€¨€¨€
¡Á¡Á¨€¡Á¡Á¡Á¡Á¡Á¡¡¡¡¡¡¡¡¡¡¡¡¡¡¡¡¨€¡Á¡Á¡Á¨€¡Á¡Á¡Á¡Á¡Á¡Á¡Á¨€
¨€¡Á¨€¡Á¨€¨€¨€¡Á¨€¨€¨€¨€¨€¨€¨€¡¡¨€¡Á¨€¡Á¨€¡Á¨€¨€¨€¡¡¨€¡Á¨€
¨€¡Á¨€¡Á¡Á¡Á¨€¡Á¨€¡Á¡Á¡Á¨€¡¡¡¡¡¡¨€¡Á¨€¡Á¡Á¡Á¨€¡¡¡¡¡¡¨€¡Á¨€
¨€¡Á¨€¨€¨€¡Á¨€¡Á¨€¡Á¨€¡Á¨€¨€¨€¨€¨€¡Á¨€¨€¨€¨€¨€¡¡¨€¨€¨€¡Á¨€
¨€¡Á¡¡¡¡¨€¡Á¨€¡Á¡Á¡Á¨€¡Á¨€¡Á¡Á¡Á¨€¡Á¨€¡¡¡¡¡¡¨€¡¡¡¡¡¡¨€¡Á¨€
¨€¡Á¨€¨€¨€¡Á¨€¨€¨€¨€¨€¡Á¨€¡Á¨€¡Á¨€¡Á¨€¨€¨€¡¡¨€¨€¨€¡¡¨€¡Á¨€
¨€¡Á¡Á¡Á¡Á¡Á¨€¡¡¡¡¡¡¨€¡Á¡Á¡Á¨€¡Á¡Á¡Á¨€¡¡¡¡¡¡¨€¡¡¡¡¡¡¨€¡Á¨€
¨€¡¡¨€¨€¨€¨€¨€¨€¨€¡¡¨€¨€¨€¨€¨€¨€¨€¨€¨€¡¡¨€¡¡¨€¡¡¨€¨€¨€¡Á¨€
¨€¡¡¡¡¡¡¡¡¡¡¨€¡¡¡¡¡¡¨€¡¡¡¡¡¡¡¡¡¡¡¡¡¡¡¡¡¡¨€¡¡¨€¡¡¨€¡Á¡Á¡Á¨€
¨€¨€¨€¨€¨€¡¡¨€¡¡¨€¡¡¨€¨€¨€¡¡¨€¨€¨€¨€¨€¨€¨€¡¡¨€¡¡¨€¡Á¨€¨€¨€
¨€¡¡¡¡¡¡¨€¡¡¡¡¡¡¨€¡¡¡¡¡¡¡¡¡¡¨€¡¡¡¡¡¡¡¡¡¡¡¡¡¡¨€¡¡¨€¡Á¨€¡¡¨€
¨€¡¡¨€¡¡¨€¨€¨€¨€¨€¨€¨€¨€¨€¨€¨€¡¡¨€¨€¨€¨€¨€¨€¨€¡¡¨€¡Á¨€¡¡¨€
¨€¡¡¨€¡¡¡¡¡¡¡¡¡¡¨€¡¡¡¡¡¡¡¡¡¡¡¡¡¡¡¡¡¡¨€¡¡¡¡¡¡¨€¡¡¨€¡Á¡Á¡Á¨€
¨€¡¡¨€¨€¨€¨€¨€¨€¨€¡¡¨€¨€¨€¨€¨€¨€¨€¨€¨€¡¡¨€¡¡¨€¡¡¨€¨€¨€¡Á¨€
¨€¡¡¨€¡¡¡¡¡¡¡¡¡¡¨€¡¡¡¡¡¡¨€¡¡¡¡¡¡¡¡¡¡¡¡¡¡¨€¡¡¡¡¡¡¨€¡¡¨€¡Á¨€
¨€¡¡¨€¡¡¨€¨€¨€¡¡¨€¨€¨€¡¡¨€¡¡¨€¨€¨€¨€¨€¨€¨€¨€¨€¨€¨€¡¡¨€¡Á¨€
¨€¡¡¡¡¡¡¡¡¡¡¨€¡¡¡¡¡¡¡¡¡¡¨€¡¡¡¡¡¡¡¡¡¡¡¡¡¡¨€¡¡¡¡¡¡¡¡¡¡¡¡¡Á¡Á
¨€¨€¨€¨€¨€¨€¨€¨€¨€¨€¨€¨€¨€¨€¨€¨€¨€¨€¨€¨€¨€¨€¨€¨€¨€¨€¨€¨€¨€
